###################
#                 #
# B    W W     B  #
#B             BB #
#      W      B   #
#            PW  W#
#   WB          BB#
#    W            #
#  WB     W       #
#  W    B     B   #
#         B B     #
#        B B  B   #
###################
