###################
#     W        B  #
#     WBW        W#
#             B   #
#       W         #
# W           B   #
#W    W BB   W   W#
#    B    W B     #
#       W  B  B   #
#   W    B   P    #
#    W  B         #
#        W BBW    #
###################
