###################
#      W   WB     #
#           BW    #
#        B  BW    #
#      B     W  B #
#     W   W  W    #
#    B            #
#             B  B#
#     B   B B    B#
#B   B           W#
# BB             W#
#    B        W P #
###################
