###################
#   BB BB B       #
#           B  BW #
#         B       #
#     W   W  B    #
#              BB #
#     B     BB    #
#  W BB  B BB B   #
# W         B     #
#              W  #
#  W   W W    PB W#
#   W         W   #
###################
